"a" = (/turf/simulated/floor/grass/alt,/area/moon/jungle)
"b" = (/obj/structure/flora/grass/jungle,/obj/structure/flora/tree/jungle/small,/turf/simulated/floor/grass/alt,/area/moon/jungle)
"c" = (/obj/structure/flora/tree/jungle/small,/turf/simulated/floor/grass/alt,/area/moon/jungle)
"d" = (/obj/structure/flora/grass/jungle,/turf/simulated/floor/grass/alt,/area/moon/jungle)
"f" = (/obj/effect/shuttle_landmark/barge/three,/turf/simulated/floor/grass/alt,/area/moon/jungle)
"g" = (/obj/structure/flora/moons/thickbrush,/turf/unsimulated/mineral,/area/moon/jungle)
"h" = (/obj/structure/railing/mapped{dir = 4},/obj/structure/railing/mapped{dir = 1},/turf/simulated/floor/plating,/area/moon/jungle)
"i" = (/obj/effect/floor_decal/industrial/warning/dust{dir = 8},/obj/effect/floor_decal/industrial/warning/dust{dir = 4},/obj/effect/decal/cleanable/dirt,/turf/simulated/floor/plating,/area/moon/jungle)
"j" = (/obj/structure/flora/moons/thickbrush,/obj/structure/flora/moons/thickbrush,/obj/structure/flora/moons/thickbrush,/turf/simulated/floor/grass/alt,/area/moon/jungle)
"k" = (/turf/simulated/floor/tiled/ramp{dir = 8},/area/moon/jungle)
"l" = (/obj/effect/decal/cleanable/dirt,/obj/effect/decal/cleanable/dirt,/obj/structure/closet/crate/drop,/obj/structure/railing/mapped{dir = 1},/obj/item/storage/field_ration/nanotrasen,/obj/item/storage/field_ration/nanotrasen,/obj/item/storage/field_ration/nanotrasen,/obj/item/storage/field_ration/nanotrasen,/obj/item/storage/field_ration/nanotrasen,/turf/simulated/floor/plating,/area/moon/jungle)
"m" = (/obj/effect/floor_decal/industrial/warning/dust{dir = 4},/obj/effect/floor_decal/industrial/warning/dust{dir = 8},/obj/effect/decal/cleanable/dirt,/turf/simulated/floor/plating,/area/moon/jungle)
"n" = (/obj/effect/decal/cleanable/dirt,/obj/effect/decal/cleanable/dirt,/obj/structure/railing/mapped,/turf/simulated/floor/plating,/area/moon/jungle)
"o" = (/obj/effect/floor_decal/industrial/warning/dust{dir = 1},/obj/effect/floor_decal/industrial/warning/dust,/obj/effect/decal/cleanable/dirt,/turf/simulated/floor/plating,/area/moon/jungle)
"p" = (/obj/effect/floor_decal/industrial/warning/dust{dir = 5},/obj/effect/floor_decal/industrial/warning/dust/corner{dir = 8},/obj/effect/decal/cleanable/dirt,/turf/simulated/floor/plating,/area/moon/jungle)
"q" = (/obj/structure/flora/tree/jungle,/turf/simulated/floor/grass/alt,/area/moon/jungle)
"r" = (/turf/unsimulated/mineral,/area/moon/jungle)
"s" = (/obj/structure/flora/moons/thickbrush,/turf/simulated/floor/grass/alt,/area/moon/jungle)
"u" = (/obj/structure/railing/mapped{dir = 1},/turf/simulated/floor/plating,/area/moon/jungle)
"v" = (/obj/effect/floor_decal/industrial/warning/dust,/obj/effect/floor_decal/industrial/warning/dust{dir = 1},/obj/effect/decal/cleanable/dirt,/turf/simulated/floor/plating,/area/moon/jungle)
"x" = (/obj/structure/flora/moons/thickbrush,/obj/structure/flora/grass/jungle,/turf/simulated/floor/grass/alt,/area/moon/jungle)
"z" = (/obj/effect/floor_decal/industrial/warning/dust{dir = 6},/obj/effect/floor_decal/industrial/warning/dust/corner{dir = 1},/obj/effect/decal/cleanable/dirt,/turf/simulated/floor/plating,/area/moon/jungle)
"A" = (/obj/effect/floor_decal/industrial/warning/dust{dir = 9},/obj/effect/floor_decal/industrial/warning/dust/corner,/obj/effect/decal/cleanable/dirt,/turf/simulated/floor/plating,/area/moon/jungle)
"B" = (/obj/effect/decal/cleanable/dirt,/obj/structure/railing/mapped,/obj/structure/railing/mapped{dir = 4},/obj/effect/decal/cleanable/spiderling_remains,/turf/simulated/floor/plating,/area/moon/jungle)
"F" = (/obj/effect/decal/cleanable/dirt,/obj/effect/decal/cleanable/dirt,/obj/structure/railing/mapped{dir = 8},/obj/structure/railing/mapped{dir = 1},/obj/machinery/power/radial_floodlight,/turf/simulated/floor/plating,/area/moon/jungle)
"G" = (/obj/effect/decal/cleanable/dirt,/obj/effect/decal/cleanable/dirt,/obj/effect/decal/cleanable/dirt,/obj/structure/closet/crate/drop,/obj/item/device/flashlight/flare,/obj/item/device/flashlight/flare,/obj/item/device/flashlight/flare,/obj/item/device/flashlight/flare,/turf/simulated/floor/plating,/area/moon/jungle)
"L" = (/obj/effect/decal/cleanable/dirt,/obj/structure/railing/mapped{dir = 4},/obj/structure/railing/mapped{dir = 1},/turf/simulated/floor/plating,/area/moon/jungle)
"M" = (/obj/structure/flora/moons/thickbrush,/obj/structure/flora/moons/thickbrush,/turf/simulated/floor/grass/alt,/area/moon/jungle)
"N" = (/obj/structure/flora/grass/jungle/b,/turf/simulated/floor/grass/alt,/area/moon/jungle)
"S" = (/obj/effect/decal/cleanable/dirt,/obj/effect/decal/cleanable/dirt,/obj/structure/railing/mapped{dir = 4},/turf/simulated/floor/plating,/area/moon/jungle)
"T" = (/obj/effect/decal/cleanable/dirt,/obj/effect/decal/cleanable/dirt,/obj/structure/railing/mapped,/obj/structure/railing/mapped{dir = 8},/turf/simulated/floor/plating,/area/moon/jungle)
"U" = (/obj/structure/flora/grass/jungle,/obj/structure/flora/grass/jungle,/turf/simulated/floor/grass/alt,/area/moon/jungle)
"V" = (/turf/simulated/floor/beach/water/ocean{name = "water"},/area/moon/jungle)
"W" = (/obj/effect/decal/cleanable/dirt,/obj/structure/closet/crate/drop,/obj/structure/railing/mapped,/obj/structure/railing/mapped{dir = 4},/obj/item/storage/field_ration/nanotrasen,/obj/item/storage/field_ration/nanotrasen,/obj/item/storage/field_ration/nanotrasen,/obj/item/storage/field_ration/nanotrasen,/obj/item/storage/field_ration/nanotrasen,/obj/effect/decal/cleanable/spiderling_remains,/turf/simulated/floor/plating,/area/moon/jungle)
"X" = (/obj/effect/floor_decal/industrial/warning/dust{dir = 10},/obj/effect/floor_decal/industrial/warning/dust/corner{dir = 4},/obj/effect/decal/cleanable/dirt,/turf/simulated/floor/plating,/area/moon/jungle)
"Y" = (/obj/effect/decal/cleanable/dirt,/obj/effect/decal/cleanable/dirt,/obj/structure/railing/mapped,/obj/effect/decal/cleanable/spiderling_remains,/turf/simulated/floor/plating,/area/moon/jungle)

(1,1,1) = {"
gggggggggggggggggggggggggggggggggggggggggggggggggggggggggggggggggggggggggggggggggggggggggggggggggggggggggggggggggggggggg
gssssssssssssssssssssssssssssssssssssssssssssssssssssssssssssssssssssssssssssssssssssssssssssssssssssssssssssssssssssssg
gssssssssssssssssssssssaassssssssssssssssssssssssssssssssssssssssssssssssssssssssssssssssssssssssssssssssssssssssssssssg
gsssssssssssssssssssssasssssssssssssssssssassssssssssssssssssssssssssssssssssssssssssssssssssssssssssssssssssssssssssssg
gssssssssaasssssssssaaaasssssaassassassasssasaassssaaasssssssssssssssssssssssssssssssssssssssssssssssssssssssssssssssssg
gsssasaaaassssssssssssaaasaasaasaaaassssaaaaasaaaasaasasssssssssssaasssssssssssssssssssssssssssssssssssssssssssssssssssg
gsssaaaaaaaasasassssssaaaasaaaaaaaaaaaaaassaaaaaassaaassssssssssssaaassssssssssssssssssssssssssssssssssssssssssssssssssg
gsssaaaaaaaaaaasassssaaaaasasaaasaaaaaaaaaaaaaaaaaaaaassssssssssssaaaaassssssssssssssssssssssssssssssssssssssssssssssssg
gsasaaaaaaaaaaasaaaaaasaasaaasaasasasaaaaassasssasaaaassssssssssssaaaasssssssssssssssssssssssssssssssssssssssssssssssssg
gsaaaaaaaaaaaaaaaaaaaasaaaassssaassssssssssssssssssaaassssssssssssaaaasssssssssssssssssssssssssssssssssssssssssssssssssg
gssaaaaaaaaaaaaaaaaaaaaaaasssssssssssssssssssssssssaasssssssssssssaaassssssssssssssssssssssssssssssssssssssssssssssssssg
gssssaaaaaaaaasaaaaaaaasaaaaaassssssssssasassssssssaaaasssssssssssaaassssssssssssssssssssssssssssssssssssssssssssssssssg
gssssaaaaaaaaasaaaaaaaaaaasaaassssssssssaaaassssssaaaassssssssssasaaaasssssssssssasasssssssssssssssssssssssssssssssssssg
gsssassaaasaaassaasssssaaaaaaasaasssssssaaassssssaaaasssssssssssssaaaasssssssssssssssssssssssssssssssssssssssssssssssssg
gssssasassasssssssssssaaassaaaaaaaasssssaaassssssaaaaassssssssssssaaassssssssssssssssssssssssssssssssssssssssssssssssssg
gsssssssssssssssssssssssssasaasaaaaaaaaaaasaasssaaaassasssssssssssaaaasssssssssaasasaasssssssssssssssssssssssssssssssssg
gssssssssssssssssssssssssssssssasaaaaaaaaaaassssasaaaasssssssssssaaaassssssssssaaaaaaasssssssssssssssssssssssssssssssssg
gsssssssssssssssssssssssssssssssssssaaaaaaaaassssassaasssssssssssaaaassssssssssaaaaaasassssssssssssssssssssssssssssssssg
gssssssssssssssssssssssssssssssssssaaaaaaaaaaassssaaaaassssssssssaaaasssssssssaaaaaaassssssssssssssssssssssssssssssssssg
gssssssssssssssssssssssssssssssssaaaaaaaaaaaaasssasaaaassssssssssaaaaassssssasaaaaaaaaassssssssssssssssssssssssssssssssg
gssssssssssssssssssaaaaaaaaaasssssaaaaaaaaaaaasssssaaassssssssssssaaaasssssssaaaaMaaassssssssssssssssssssssssssssssssssg
gssssssssssssssssssaaaaaaaaaassssssaaaaaaaaaaassssssaaasssssssssssaaassssssssaaaasaaaasssssssssssssssssssssssssssssssssg
gssssssssssssaaaaaaaaaaaaaaaaassssssaaaaaaaaassssasasaasssssssssssaaassssssssaaasjaaaasssssssssssssssssssssssssssssssssg
gssssssssssssaaaaaaaaaaaaaaaasassssssaaaaaaaasssssssaaaasssssssssaaaassssssssaaasaaaassssssssssssssssssssssssssssssssssg
gssssssssssssaaaaaaaaaaaaaaaasassssssssaaaasssssssssaaasssssssssssaaaasssssasaaasssaassssssssssssssssssssssssssssssssssg
gssssssssssssaaaaaaaaaararraasasssssssssassssssssssasaasssssssssssaaaasssssssaaasaaaasaasssssssssssssssssssssssssssssssg
gssssssssssssaaaaaaaaaararraasassssssssssssssssssssaaassssssssssssaaassassssaaaaaMaaassssssssssssssssssssssssssssssssssg
gsssssssssaasaaaaaaarraaaaaaasassssssssssssssssssssaaasssaaaasssssaaasassssssaaaaasaaaassssssssssssssssssssssssssssssssg
gsssssssssaasaaaaaarrrrraarrassssssssssaaaaaasssssssaaaasaaaasssssaaaasssssssaaassaaaasssssssssssssssssssssssssssssssssg
gssssssssssssaaarrarrrraaarrrasaaaaaaaaaaaaaaaaaassaassssssssaaassaaassssssssaaassaaaasssssssssssssssssssssssssssssssssg
gssssssssssssaarrraaarraarrrrasaaaaaaaasssaaaaaaaaaaaasssssssaaassaaaassssssaaaaaMsaassssssssssssssssssssssssssssssssssg
gsssssssssssadarrraaraaaarrrraaaaaaasssssssssaaaaaadaaaasssssaaasaaaaasssssssaaaassaassssssssssssssssssssssssssssssssssg
gsssssssssssadarrraaraaaarrraaaaaasssssssssssaaaaaaadaaassssssaassaaaasssssssaaaaMsaassssssssssssssssssssssssssssssssssg
gsssssssssssadarraaaaaaaaaaaaaaaaaaasaaasasaaaaaaaaaadaaaaaaassssaaaaasasssssaaaaaaaassssasssssssasssssssssssssssssssssg
gsssssssssssaadrraaaaaaaaraaaasssaaassssssssassssssaaaddddddaaaaaaaaasassssssaaaaaaaasasassssasssssssssssssssssssssssssg
gsssssssssssaadarrrrraaaaraaaaassaaaasssssasssssaaaaaaaaaaaaaddaaaaaassssssssaaaaaaaasssasassssssasssssssssssssssssssssg
gssssssssssssadarrrrrrarraaaaaassaaassassaasssssssssssssssssssaaddaaaaasaasssssaaaaaasasassssaasssssasassssssssssssssssg
gssssssssssaaadaaaaaaaarraaaaaasssssasssassasssssssasasassssssaaaaaaaadaaasssssaaaaaaaaasaasssaaasassssssssssssssssssssg
gssssssssssaadaaaaadaaarraaaaaassssssssaasassasssasssassssssssaaaaaaaaadaaaaaasaaaaaasssassassassssaaaaaassssssssssssssg
gsssssssssssxaaaradaaddddaaaaaasaasssssasassassassssasssaassssssssssaaaddaaaaassaaaaasaasasassasasaaaaassssssssssssssssg
gsssssssssasdaaaradaarraadaaasssaaasaasaasaaaasaaaasasassaaassasssssaaaaadaaaassaaaaasaasaassaaaaaaassasassssssssssssssg
gsssssssssssdaaarddarrrraddaaaasaassasssaassaasassaaaassaaaaaassssssaasaaaadaaaaaaaaasasaasassaaaaaaaasasssssssssssssssg
gsssssssssaadaaardaarrrrraddaaassssssssassssassssssssaaassssaasssssssssaaaaaaaaassssssssaasaasasaasaassssssssssssssssssg
gsssssssssaadaaaadarrrrrraadaaaaaasassssaasasssassaasssssssssasasssssssaaaaaaaaaaaasssssssssssssaassassssssssssssssssssg
gsssssssssssdaaaadarraaaaaadasaaaassssssaaaaaaassssaaassaasaaassassssssaaaaaaaddaaasssssssassasasaaasssssssssssssssssssg
gsssssssssssdaaaadarrraaaaadasaaaassssasssssssassassaasasassassssssssssssaaasaadaaasssssssssssssassssssssssssssssssssssg
gssssssssssaadaadddaaaaaaddaasaaassssssssssssssssssssssssaaaarrssssssssssaaasaadaaassssssssssssaaasssssasssssssssssssssg
gssssssssssaaaadddaUadaaddddaaaassssssssssssaasssssssssssaaassaasssssssssaaasaddddasssssssssssassaassasssssssssssssssssg
gssssssssssaaaadaaaaadUdadaaaaasssssasssssaaaaaassaaaasaaaaassaaaaaasssssssssaaddaassssssssssaaaaaaasasssssssssssssssssg
gssssssssssaaadaaaaaaaaaaaaaaaaaasssaaasssasVssaassddassscaassadddaasssssssssaaaadasssssasassssssassaassssassssssssssssg
gssssssssssaadaaaaaaassssssaaaaaasssaaasssaVVVVVaddddddaadddddadddaaaaassssssaaaddassssssssssasssaassssssaassssssssssssg
gssssssssssaaadassssssssssaaaaaaaassaaaaasssVVVdddddddddaaaaaaaaacaaddaVVssssaaaaaasssssssaasssssaaassaaassssssssssssssg
gsssssssssssssadsssssssssssaaaaaaassaasarssasVAoooooooooooooooooooooopVVassssssaaaaassssssssssssassssssssssssssssssssssg
gsssssssssssssddssssssssaasaaasssassaasrrssasViaaaaaaaaaaaaaaaaaaaaaamdsssssasssssaaaasssssssaaassssasassssssssssssssssg
gsssssssssssssdassssssssaasssasssssssssrrssasaiaaaaaaaaaaaaaaaaaaaaaamdasssssasasaaaaasssssssssssssasssaassssssssssssssg
gsssssssssssssddssssssssaasssasssssssssrrssasaiaaaaaaaaaaaaaaaaaaaaaamdassssasssasaddasssssasassasssssssaasssssssssssssg
gssssssssssssaaasssaaaassssssssssssssssrrssasaiaaaaaaaaaaaaaaaaaaaaaamcassssaassssaadaaasaaassaassasaaaaaasssssssssssssg
gsssssssssaaaaaasssaaaassssasssssassssarrssaaaiaaaaaaaaaaaaaaaaaaaaaamaasssasassssaaaaaassssssssaaassssssssssssssssssssg
gssssssssaaaasssssaaaaassaassssaaaassssrassssaiaaaaaaaaaaaaaaaaaaaaaamaaasssssssssaadaaasssssssssssssasaassssssssssssssg
gssssssaassadsssssaasssasasssasaaasssssrasssaaiaaaaaaaaaaaaaaaaaaaaaamasassssaassaaaaaaasssssssssassaaasssassssssssssssg
gssssssaassdasssssaassssssssaasaaasssasrasssaaiaaaaaaaaaaaaaaaaaaaaaamdsassasaasaaaaaaaaasssassssssasssasasssssssssssssg
gssssssaaaadassssssasssssaassssaaasssasassssaqiaaaaaaaaaaaaaaaaaaaaaamdacsssasssaaaaaaacssassaaassssaasssssssssssssssssg
gssssssaddaadssssssasssssasssssaaasaaarassssaaiaaaaaaaaaaaaaaaaaaaaaamddassssaassaaadaaassssassssssaaaaasasasssssssssssg
gssssssaddddxssssssasssssaassaaaaasaasraasssadiaaaaaaaaaaaaaaaaaaaaaamddasssssassaaadaaaasssasssasaaaaaasasssssssssssssg
gssssssaaxaasssssaaasssasaaaaaaaaasaasraassssdiaaaaaaaaaaaaaaaaaaaaaamddasssassssaaadssaasassssaasaaaaaasssassassssssssg
gssssssassaasssssaaaassssaaassaaassaasraassssaiaaaaaaaaaafaaaaaaaaaaamddassssaassaaddssaassssassaasaaaaaasaasssssssssssg
gssssasassaasssssarrassssaaasssaaasaasarassssaiaaaaaaaaaaaaaaaaaaaaaamasasssssassaadassaassssasssssaaaaasaaassassssssssg
gssssaaassaasssssarrasssaaaaasaaaaaaarsrassssaiaaaaaaaaaaaaaaaaaaaaaamasassssasssaadasasssasssasssassaaasssssasssssssssg
gsssaaaaaaaasssssaaaasasaaaaaaaaaaasarsaassssaiaaaaaaaaaaaaaaaaaaaaaamasassssasssadaassssssssssssaassasaassssssssssssssg
gsssaaaaaaaassssssaaasssasaaarraacasassaasaasaiaaaaaaaaaaaaaaaaaaaaaamassssssssasaaassssaaasssssssaasaassasaassssssssssg
gsssaacadaaasssaaaaassssssasarrraaasaasaasaaaaiaaaaaaaaaaaaaaaaaaaaaamdaassssssaaasssssssaassssasssaaaasasassssssssssssg
gssssaaadaaasssaaaaassssaaassrrraaasaaraasssaciaaaaaaaaaaaaaaaaaaaaaamdsssssssssacsssaassaassasaaasasssasssssssssssssssg
gssssaaaaadaasssaadasssssassssaaraaaaaracsaadViaaaaaaaaaaaaaaaaaaaaaamdasssssssaaasasaassaaasssssssssssssssssssssssssssg
gsssaaadddddasssaadasssssassssaaaaaaaarrasaaaViaaaaaaaaaaaaaaaaaaaaaamdasssssssasaasssassaaaassssssssssasssssssssssssssg
gsssaaadadddasssaaaassssssaassaaaraasarrasacVViaaaaaaaaaaaaaaaaaaaaaamaassssssssaaassssssaasssasaassssassasasssssssssssg
gsssaaaaadaaaassaaadassssassaaaaaraaaaarasadVdiaaaaaaaaaaaaaaaaaaaaaamcasssssssaasassssssaassasssssasssssssssssssssssssg
gsssaaaadaaaasssssaaassssassacaaaaaaaaasasaVVViaaaaaaaaaaaaaaaaaaaaaamddaassssssssaasasssaassasssasaassssssssssssssssssg
gsssaaadddaaaaassaadaaasssssaaaaaaaaasssassssViaaaaaaaaaaaaaaaaaaaaaamddaasssssassssassssaassssassasasaasasaassssssssssg
gssssaaddaaaaaassaadaaasssssaaaasaaaaaaaaasssaiaaaaaaaaaaaaaaaaaaaaaamddaasssaaaaaassssssaasssssasssssassssssssssssssssg
gssssddaddaaaaaaaaadaaaaaaassaaaaaaaaaaaaasssaiaaaaaaaaaaaaaaaaaaaaaamaaassssaaddaassssassssssssasaaasssassaasassssssssg
gssssaaadaaasssssdddssaaaaaaaaaaasaraaaasaaasaXvvvvvvvvvvvvvvvvvvvvvvzaasssssadaaaasssssssssasssssaaasssassssssssssssssg
gssssdaaddaasssssdaassssaaaaaraasaaraassaaaasssaaaNaaaaNaddaaaaddassaaaassssssdasssssssssssasssaaaasssssasssassaassssssg
gssssadaaadasssssdaassssssaasssssssaassssaaasssaNaasaadaaaaaaaaddaaaasssssssaddasssssssasssssssssasassssaaassssssssssssg
gssssadaadaasssssaaasssssssssssssssaaaassssaasssssssaaNdaaaaadddasssssssssssadaasssssssssssasssaaaaasssasssssssssssssssg
gssssaadaaddsssssaddaaasssssssssssaaaaaassssasssssssaaaaaaNaadddasssssssssasadassssssssssssasassaasaaaaasssasssssssssssg
gssssaaaaaaaassssaaddddsssssssssssddaaassassaaassssssaklLaasskuhasssssssssaaadasssasssssssssssaasaasssaassssssssassssssg
gssssaaadaacassssaadaaddssssssssssaaddaaaassaaaaaaaasakYWaaaaFGSasssssssaaascdassssssssssssaaaaaaaaasssssssssssssssssssg
gssssssaaaaaassssaaadaaddaaaassssssaaadaaassaaaVVaassssaaaNaaTnBasssssssaaasadassssasasssssssaaasaasasssssassssssssssssg
gssssssaadassssssssaadaaaadaasssssssaaddaasassaVVVasssaaaaaaaassssssssssaaadaaassssssssssaaasaasssssaasssssssssssssssssg
gssssssaadasaasasssssadaaaadasssssssssaadassssaaaVassssaaaaaasssssssssaaddaaddaaaaasssassssassssaasssssaassssssssssssssg
gssssssacdasaasasssssaddaaaaassssssssssaddssssaaaaaasssNNNNNssaassssssaadacaaadaaaasassaassssasssssssasssssssssssssssssg
gssssssaaaaaaassasssssaadaaaassssssssssadassssasaasssssaNaNNssaasssaaaaadsaaasdaaaasssssssssasaaaaaaassssssssssssssssssg
gsssssssaasaaaasssssssssadddassssssssssaaaasssssssaassaNNNNNaaaaassaaaadasssasaddaaassassssssssaasasaasssssssasssssssssg
gsssssssssaaaaaassssssssaaaaxxssssssssssssaaaaasssaaaaaNNNNNaaaaaaaaaaaaaassssaabaaasaaaasaaassaaaaasssassssassssssssssg
gsssssssssddadaaaaaasssssssaaassssssssssssaaaaasaaaaaaaassaassssssssadsaaassssaaaaassssssssaasssssaaassssssssssssssssssg
gsssssssssaaaaaadaddsssssssaaassssssssaaaaaaaaaasssaaaasssaassssssssadssssssssaaaaasassassaaaasasasssssaasssassssssssssg
gsssssssssaaaaaasasddssssssaaaassssssaaaaaaaaaaasssaasasssaassssssssadaassssssssssasasassasassasssssasassssssssssssssssg
gsssssssssssssaasaaaddassssssssasssssadaddasaaaassssssssssaaasssssssadaaasasssssasssssassasasasasssssssaassasssssssssssg
gsssassssssssssssssaaddasssssasasssssadaaaasaasssssssssssssaaxssssaaaaaaasssssassaasssssaassssssaaasassassassssssssssssg
gssssssssssssssssssssaddaassssssssaaaddaaaasaasssssssssssssaadaacaaaasssssssssssasssssssaasaaassaasssaassssssssssssssssg
gsssssaaasssssssssssssaddaasssassaaaddasaaasaasssssssssssssaaadadddaasssssssssssssssssasaassaasasasssasssssssssssssssssg
gssadsadasssssssssssssssaddaaaasaddddaasssssddssssssssssssssaaaaaaaasassssasssssasssssasssssssssassssassasssssassssssssg
gssddsaadaaassssssssssssssaaaaaaddaaaaasssssadaassssssssssssssssssssssasssasssssssssssassssaassssssasasssssssssssssssssg
gssaasaacdaasssssssssssssadddaaddasaasssssssaddaaasssssssssssasssssssssssssasssassssssasssassssssssssaaaassasssssssssssg
gsssssasaddasssssssssaaaadaaddaaaasassssssssaadaaassssssssssssssssssssssssssasasssasssssssssasasasasasassssssssssssssssg
gsssssaaaaddaasssssssadddaaaaaaaaassssssssssaaddaasaaaaaaaaasssssssssssssassasssssssaaasssssssssasassssssasssssssssssssg
gsssssssssaddassssaddadaaasssssassssssssaassaaadddsaaaaddaaassssssssasssassasassssasssssssssassssssssaaaaaassssssssssssg
gssssasssssaddaaaaadasssssssssaaasssssssaassaaadddsaadddaaaasssssssssssssaassassssssssssssssssaassssssssassssssssssssssg
gssssasssasssddddddaassssssaaaaaaaaassssssssaaaaaasadadaaaaassssssaassssssssssssssssssassssssssssssasasasassssssssassssg
gssssassssssaaddassssssssssaadddaddassssssssssssssaadaacaaaaassssasssasssssassssssassasassssassssssssasasssaassssssssssg
gsssssassssssaaaaaasssssssssssaadddassssssssssssssaadddaaaaasssssasssssssssssssssssssssssssssssssassassasasssaassssssssg
gsssssaassaasaaasssadasssssssaaaaddassaddaaaassssssaddaaaaaasaasssssssassssssssssssssssasssssssssssasssssssssssssasasssg
gsssssssssaasssssssaadssssssssssssssssaaddassssssssddaaaaaaasaassssssssssssassssssssssssssssssssssassssaasssssssassssssg
gssssssssssssssssssaaadaaaasaaaaaaaassssaddcaaaaasaaaaasssssssssssassssssssasssssssssssassssssssssssssssasssassssssssssg
gsssssssssssssssssssssaddaasaaaaaassssssssadddaaasaaaaasssssssssssssssssassssssssssssssssssssssssssssssssssssssasssssssg
gsssssssssssssssssssssaadddsssssssssssssssaaaassaaacaassassssssssssssssssssssssssssssssssasssasssssssssasssssssssssssssg
gsssssssssssssssssssssssssssssssssssssssssssssssaaaaaaaassssssssssssssssssssssssssssssssssssssssssssssssssssassssssssssg
gssssssssssssssssssssssssssssssssssssssssssssssssssssssssssssssssssssssssssssssssssssssssssssssssssssssssasssssssssssssg
gssssssssssssssssssssssssssssssssssssssssssssssssssssssssssssssssssssssssssssssssssssssssssssssssssssssssssssssssssssssg
gggggggggggggggggggggggggggggggggggggggggggggggggggggggggggggggggggggggggggggggggggggggggggggggggggggggggggggggggggggggg
"}
